# Vietnamese Sign Language Dictionary
# Format: vietnamese_word = SIGN_LANGUAGE_WORD
# Lines starting with # are comments
# Empty lines are ignored
# Words with spaces should use underscores: word_here = SIGN-HERE

# === ĐẠI TỪ NHÂN XƯNG ===
tôi = TÔI
mình = TÔI
em = TÔI
bạn = BẠN
anh = BẠN
chị = BẠN
cô = BẠN
họ = HỌ
chúng_ta = CHÚNG-TA
chúng_tôi = CHÚNG-TÔI

# === ĐỘNG TỪ CƠ BẢN ===
là = LÀ
có = CÓ
không = KHÔNG
đi = ĐI
đến = ĐẾN
về = VỀ
tới = TỚI
ăn = ĂN
uống = UỐNG
ngủ = NGỦ
làm = LÀM
học = HỌC
đọc = ĐỌC
viết = VIẾT
nói = NÓI
nghe = NGHE
nhìn = NHÌN
thấy = THẤY
yêu = YÊU
thích = THÍCH
ghét = GHÉT
mua = MUA
bán = BÁN
cho = CHO
lấy = LẤY

# === TÍNH TỪ ===
đẹp = ĐẸP
xấu = XẤU
tốt = TỐT
lớn = LỚN
nhỏ = NHỎ
cao = CAO
thấp = THẤP
dài = DÀI
ngắn = NGẮN
rộng = RỘNG
hẹp = HẸP
nóng = NÓNG
lạnh = LẠNH
ấm = ẤM
mát = MÁT
vui = VUI
buồn = BUỒN
giận = GIẬN
hạnh_phúc = HẠNH-PHÚC

# === DANH TỪ THƯỜNG GẶP ===
nhà = NHÀ
trường = TRƯỜNG
lớp = LỚP
bàn = BÀN
ghế = GHẾ
cửa = CỬA
cửa_sổ = CỬA-SỔ
nước = NƯỚC
cơm = CƠM
bánh = BÁNH
trà = TRÀ
mẹ = MẸ
bố = BỐ
con = CON
ông = ÔNG
bà = BÀ

# === TỪ CHỈ THỜI GIAN ===
hôm_nay = HÔM-NAY
ngày_mai = NGÀY-MAI
hôm_qua = HÔM-QUA
sáng = SÁNG
trưa = TRƯA
chiều = CHIỀU
tối = TỐI
tuần = TUẦN
tháng = THÁNG
năm = NĂM

# === TỪ CHỈ NƠI CHỐN ===
đây = ĐÂY
đó = ĐÓ
kia = KIA
trong = TRONG
ngoài = NGOÀI
trên = TRÊN
dưới = DƯỚI
bên = BÊN
giữa = GIỮA
gần = GẦN
xa = XA

# === SỐ ĐẾM ===
một = 1
hai = 2
ba = 3
bốn = 4
năm = 5
sáu = 6
bảy = 7
tám = 8
chín = 9
mười = 10

# === CÂU HỎI ===
gì = GÌ
ai = AI
đâu = ĐÂU
khi_nào = KHI-NÀO
như_thế_nào = NHƯ-THẾ-NÀO
tại_sao = TẠI-SAO

# === GIÁO DỤC & HỌC TẬP ===
đại_học = ĐẠI-HỌC
khoa_học = KHOA-HỌC
tự_nhiên = TỰ-NHIÊN
công_nghệ = CÔNG-NGHỆ
thông_tin = THÔNG-TIN
sinh_viên = SINH-VIÊN
giáo_viên = GIÁO-VIÊN
bài_học = BÀI-HỌC
kiểm_tra = KIỂM-TRA
thi = THI

# === THÀNH PHỐ & ĐỊA DANH ===
việt_nam = VIỆT-NAM
hà_nội = HÀ-NỘI
hồ_chí_minh = HỒ-CHÍ-MINH
đà_nẵng = ĐÀ-NẴNG

# === CÁC TỪ KHÁC ===
tiếng = TIẾNG
ngôn_ngữ = NGÔN-NGỮ
ký_hiệu = KÝ-HIỆU
từ = TỪ
câu = CÂU
văn_bản = VĂN-BẢN
