# Vietnamese Sign Language Dictionary
# Format: vietnamese_word = SIGN_LANGUAGE_WORD
# Lines starting with # are comments
# Empty lines are ignored
# Words with spaces should use underscores: word_here = SIGN-HERE

# === ĐẠI TỪ ===
tôi = TÔI
mình = TÔI
em = TÔI
bạn = BẠN
anh = BẠN
chị = BẠN
cô = BẠN
họ = HỌ
chúng_ta = CHÚNG-TA
chúng_tôi = CHÚNG-TÔI

# === ĐỘNG TỪ ===
là = LÀ
có = CÓ
không = KHÔNG
đi = ĐI
đến = ĐẾN
về = VỀ
ăn = ĂN
uống = UỐNG
ngủ = NGỦ
làm = LÀM
học = HỌC
đọc = ĐỌC
viết = VIẾT
nói = NÓI
nghe = NGHE
nhìn = NHÌN
yêu = YÊU
thích = THÍCH
mua = MUA
bán = BÁN
cho = CHO

# === TÍNH TỪ ===
đẹp = ĐẸP
xấu = XẤU
tốt = TỐT
lớn = LỚN
nhỏ = NHỎ
cao = CAO
thấp = THẤP
vui = VUI
buồn = BUỒN

# === DANH TỪ ===
nhà = NHÀ
trường = TRƯỜNG
lớp = LỚP
bàn = BÀN
ghế = GHẾ
nước = NƯỚC
cơm = CƠM
bánh = BÁNH
mẹ = MẸ
bố = BỐ
con = CON

# === THỜI GIAN ===
hôm_nay = HÔM-NAY
ngày_mai = NGÀY-MAI
hôm_qua = HÔM-QUA
sáng = SÁNG
chiều = CHIỀU
tối = TỐI

# === NƠI CHỐN ===
đây = ĐÂY
đó = ĐÓ
trong = TRONG
ngoài = NGOÀI
trên = TRÊN
dưới = DƯỚI

# === SỐ ===
một = 1
hai = 2
ba = 3
bốn = 4
năm = 5
sáu = 6
bảy = 7
tám = 8
chín = 9
mười = 10

# === CÂU HỎI ===
gì = GÌ
ai = AI
đâu = ĐÂU
khi_nào = KHI-NÀO
tại_sao = TẠI-SAO

# === GIÁO DỤC ===
đại_học = ĐẠI-HỌC
khoa_học = KHOA-HỌC
công_nghệ = CÔNG-NGHỆ
thông_tin = THÔNG-TIN
sinh_viên = SINH-VIÊN
giáo_viên = GIÁO-VIÊN

# === ĐỊA DANH ===
việt_nam = VIỆT-NAM
hà_nội = HÀ-NỘI

# === KHÁC ===
tiếng = TIẾNG
ngôn_ngữ = NGÔN-NGỮ
từ = TỪ
câu = CÂU
